wwwwwdwwwww
w---------w
w-rrrrrrr-w
w-r-----r-w
w-r-rrr-r-w
d-r-r-r-r-d
w-r-rrr-r-w
w-r-----r-w
w-rrrrrrr-w
w---------w
wwwwwdwwwww
