wwwwwwwdwwwwwww
w1------------w
w----------3--w
w-r-r-r-r-r-r-w
d-------------d
w-r-r-r-r-r-r-w
w--3----------w
w------------1w
wwwwwwwdwwwwwww
