wwwww-wwwww
wrr-r-r-rrw
wr-------rw
w---------w
wr---r---rw
----r-r----
wr---r---rw
w---------w
wr-------rw
wrr-r-r-rrw
wwwww-wwwww