wwwwwdwwwww
w---------w
w-rr---rr-w
w-r-----r-w
w---r-r---w
d---------d
w---r-r---w
w-r-----r-w
w-rr---rr-w
w---------w
wwwwwdwwwww
