wwwwwdwwwww
w---------w
w-rrr--rr-w
w-r-----r-w
w-------r-w
d---------d
w-r-------w
w-r-----r-w
w-rr--rrr-w
w---------w
wwwwwdwwwww
