wwwwwdwwwww
w---------w
w-rr---rr-w
w-r-----r-w
w----r----w
d---rrr---d
w----r----w
w-r-----r-w
w-rr---rr-w
w---------w
wwwwwdwwwww
