wwwwwwwwwww
w---------w
w-rr---rr-w
w-r-----r-w
w----r----w
w---rrr---w
w----r----w
w---------w
w---------w
w---------w
wwwwwdwwwww
