wwwwwwwwwww
wrrrrrrrrrw
wr--rrr--rw
wr---r---rw
wr-------rw
wr-------rw
wr-------rw
wr-------rw
wr-------rw
wr-------rw
wwwww-wwwww