wwwwwwwwwww
w---------w
w-rrr-rrr-w
w-r-----r-w
w-r-----r-w
w-r-----r-w
w-r-----r-w
w-r-----r-w
w-rr---rr-w
w---------w
wwwwwdwwwww
