wwwwwwwwwwwwwww
w-------------w
w-2---------2-w
w------1------w
w-------------w
w-------------w
w-------------w
w-------------w
wwwwwwwdwwwwwww
