wwwwwwwwwww
w---------w
w----r----w
w----r----w
w----r----w
w----r----w
w---r-r---w
w---r-r---w
w----r----w
w---------w
wwwww-wwwww
