wwwwwwwwwww
w---------w
w-rrrrrrr-w
w-r-----r-w
w---------w
w---------w
w---------w
w--r---r--w
w---------w
w---------w
wwwwwdwwwww
