wwwwwwwwwwwwwww
w-------------w
w---rrr-rrr---w
w--r-2-r-2-r--w
w---r-----r---w
w-------------w
w--r-------r--w
w-------------w
wwwwwwwdwwwwwww
