wwwwwwwwwww
w---------w
w-rr---rr-w
w-r-----r-w
w---------w
w----r----w
w---------w
w---------w
w---------w
w---------w
wwwww-wwwww
