wwwwwwwwwwwwwww
w-------------w
w------3------w
w-------------w
w-------------w
w-------------w
w--r-------r--w
w-------------w
wwwwwwwdwwwwwww
