wwwwwdwwwww
w---------w
w-------r-w
w---------w
w---------w
d---------w
w---------w
w-------r-w
w-r----rr-w
w---------w
wwwwwwwwwww
