wwwww-wwwww
w---------w
w---------w
w------r--w
w---------w
----------w
w-rr------w
w-r-----r-w
w-r----rr-w
w---------w
wwwwwwwwwww
