wwwwwdwwwww
w---------w
w-rr------w
w-r-------w
w---------w
d-------r-w
w-------r-w
w-------r-w
w----rrrr-w
w---------w
wwwwwwwwwww
