wwwwwwwdwwwwwww
w-------------w
w-------------w
w-------------w
d-------------w
w-------------w
w-----------2-w
w-------------w
wwwwwwwwwwwwwww
