wwwwwwwwwww
w---------w
w-rr------w
w-r-------w
w----r----w
w---rrr---d
w----r----w
w-r-------w
w-rr------w
w---------w
wwwwwwwwwww
