wwwwwwwwwww
w---------w
w-rrrrrrr-w
w-r-----r-w
w-r-------w
w---------d
w-r-------w
w-r-----r-w
w-rrrrrrr-w
w---------w
wwwwwwwwwww
