wwwwwwwwwww
w---------w
w-rr------w
w-r-------w
w---------w
w----r-----
w---------w
w-r-------w
w-rr------w
w---------w
wwwwwwwwwww
