wwwwwwwwwwwwwww
w-r---2-r---2-w
wr--r--r--r--rw
w--r--r--r--r-w
w2r--r--r--r--d
wr--r--r--r--rw
w--r--r--r--r-w
w---2r-----r--w
wwwwwwwwwwwwwww
