wwwwwwwwwww
w---------w
w-r---rrr-w
w---------w
w---------w
-----------
w---------w
w---------w
w-rrr---r-w
w---------w
wwwwwwwwwww
