wwwwwwwwwww
w---------w
w-rrrrrrr-w
w-r-----r-w
w-r-----r-w
d---------d
w-r-----r-w
w-r-----r-w
w-rrrrrrr-w
w---------w
wwwwwwwwwww
