wwwwwwwwwww
w---------w
w-rrr-rrr-w
w-r-----r-w
w---------w
d---------d
w---------w
w-r-----r-w
w-rrr-rrr-w
w---------w
wwwwwwwwwww
