wwwwwwwwwwwwwww
w--r------r-2-w
w-r------r---rw
wr--rrr-----r-w
d--r-------r--d
w-r-----rrr--rw
wr---r------r-w
w-2-r------r--w
wwwwwwwwwwwwwww
