wwwwwwwwwwwwwww
w-------------w
w---------3---w
w-------------w
d-------------d
w-------------w
w---3---------w
w-------------w
wwwwwwwwwwwwwww
