wwwwwwwwwww
w---------w
w-rr---rr-w
w-r--r--r-w
w---rrr---w
d--rr-rr--d
w---rrr---w
w---------w
w-r-----r-w
w---------w
wwwwwdwwwww
