wwwww-wwwww
w---------w
w---------w
w--r---r--w
w---------w
w----e----w
w-r--r--r-w
w--rr-rr--w
w---------w
w---------w
wwwwwwwwwww
