wwwwwwwwwww
w---------w
w------rr-w
w-------r-w
w----r----w
d---rrr---w
w----r----w
w-------r-w
w------rr-w
w---------w
wwwwwwwwwww
