wwwwwwwwwww
w---------w
w------rr-w
w--r----r-w
w-------r-w
d-------r-w
w-------r-w
w--r----r-w
w------rr-w
w---------w
wwwwwwwwwww
