wwwwwwwwwwwwwww
w--r-----r2---w
w-r--r--r--r--w
wr--r--r--r--rw
d--r--r--r--r2w
w-r--r--r--r--w
wr--r--r--r--rw
w-2---r-2---r-w
wwwwwwwwwwwwwww
