wwwwwdwwwww
w---------w
w-r-------w
w---------w
w---------w
w---------d
w---------w
w-r-------w
w-rr----r-w
w---------w
wwwwwwwwwww
