wwwwwwwdwwwwwww
w-------------w
w-r-r-r-r-r-r-w
w-------------w
wr-r-r-r-r-r--d
w--1----------w
wrr-r-r-r-r-rrw
w----1--------w
wwwwwwwwwwwwwww
