wwwwwdwwwww
w---------w
w------rr-w
w-------r-w
w---------w
w-r-------d
w-r-------w
w-r-------w
w-rrrr----w
w---------w
wwwwwwwwwww
