wwwwwwwwwwwwwww
w-------------w
w-----------1-w
w-------------w
d-------------w
w-------------w
w-------------w
w-------------w
wwwwwwwdwwwwwww
