wwwwwwwwwww
w---------w
w-r----rr-w
w-------r-w
w---------w
d---------w
w---------w
w---------w
w-------r-w
w---------w
wwwwwdwwwww
