wwwwwwwwwww
w---------w
w------rr-w
w--r----r-w
w---------w
----------w
w---------w
w-----r---w
w-----rrr-w
w---------w
wwwww-wwwww
