wwwwwwwwwwwwwww
w--------1----w
wrr-r-r-r-r-rrw
w----------1--w
d--r-r-r-r-r-rw
w-------------w
w-r-r-r-r-r-r-w
w-------------w
wwwwwwwdwwwwwww
