wwwwwwwwwww
w---------w
w----rrrr-w
w-------r-w
w-------r-w
d-------r-w
w---------w
w-r-------w
w-rr------w
w---------w
wwwwwdwwwww
