wwwwwdwwwww
w---------w
w-rrr-rrr-w
w-r-----r-w
w-r-----r-w
w-r-----r-w
w-r-----r-w
w-r-----r-w
w-rrr-rrr-w
w---------w
wwwwwdwwwww
