wwwwwwwdwwwwwww
w-------------w
w-2r-------r2-w
w-------------w
w-------------w
w-r---------r-w
w-2---------2-w
w-------------w
wwwwwwwdwwwwwww
