wwwwwdwwwww
w---------w
w-rr---rr-w
w-r-----r-w
w-r-----r-w
w---------w
w-r-----r-w
w-r-----r-w
w-rr---rr-w
w---------w
wwwwwdwwwww
