wwwwwdwwwww
w---------w
w---------w
w---------w
w----r----w
w---rrr---w
w----r----w
w-r-----r-w
w-rr---rr-w
w---------w
wwwwwwwwwww
