wwwww-wwwww
wr-------rw
wr-------rw
wr-------rw
wr-------rw
wr-------rw
wr-------rw
wr---r---rw
wr--rrr--rw
wrrrrrrrrrw
wwwwwwwwwww