wwwww-wwwww
wr-------rw
wr-------rw
wr-------rw
w---------w
w---------w
w---------w
wr-------rw
wr--r-r--rw
wrrrrrrrrrw
wwwwwwwwwww