wwwwwdwwwww
w---------w
w-rr---rr-w
w-r-----r-w
w-r-----r-w
w-r-----r-w
w-r-----r-w
w-r-----r-w
w-rrr-rrr-w
w---------w
wwwwwwwwwww
