wwwwwwwdwwwwwww
w-------------w
w-------------w
w-------------w
w--rrrrrrrr---w
w------1------w
w-2---------2-w
w-------------w
wwwwwwwwwwwwwww
