wwwwwdwwwww
w---------w
w---------w
w--r---r--w
w---------w
w---------w
w---------w
w-r-----r-w
w-rrrrrrr-w
w---------w
wwwwwwwwwww
