wwwwwwwdwwwwwww
w-------------w
w--r-------r--w
w-------------w
w---r-----r---w
w--r-2-r-2-r--w
w---rrr-rrr---w
w-------------w
wwwwwwwwwwwwwww
