wwwww-wwwww
w---------w
w---------w
w---------w
w---------w
w----r----w
w---------w
w-r-----r-w
w-rr---rr-w
w---------w
wwwwwwwwwww
