wwwwwwwdwwwwwww
w-------------w
w--r-------r--w
w-------------w
w-------------w
w-------------w
w------3------w
w-------------w
wwwwwwwwwwwwwww
