wwwwwwwwwww
w---------w
w-------s-w
w---------w
w---------w
-----------
w---------w
w---------w
w---------w
w---------w
wwwww-wwwww
