wwwwwwwwwww
w---------w
w-rr----r-w
w-r-------w
w---------w
w---------d
w---------w
w---------w
w-r-------w
w---------w
wwwwwdwwwww
