wwwwwwwwwww
w---------w
w-rrrr----w
w-r-------w
w-r-------w
w-r-------d
w---------w
w-------r-w
w------rr-w
w---------w
wwwwwdwwwww
