wwwwwwwwwww
w---------w
w-r-------w
w---------w
w---------w
w-s--------
w---------w
w---------w
w-r-------w
w---------w
wwwwwwwwwww
