wwwwwdwwwww
w---------w
w-r----rr-w
w----r--r-w
w---rrr---w
d---r-rr--w
w---rrr---w
w----r--r-w
w-r----rr-w
w---------w
wwwwwdwwwww
