wwwww-wwwww
w-------rrw
w--------rw
w--------rw
w---------w
---------rw
w---------w
w--------rw
w--------rw
w-------rrw
wwwww-wwwww