wwwwwwwdwwwwwww
w-------------w
w-rrr------3--w
w-r-----------w
d-------------w
w-r-----------w
w-rrr------3--w
w-------------w
wwwwwwwdwwwwwww
