wwwwwdwwwww
w---------w
w-r-----r-w
w---------w
w---rrr---w
d--rr-rr--d
w---rrr---w
w-r--r--r-w
w-rr---rr-w
w---------w
wwwwwwwwwww
