wwwwwwwdwwwwwww
w-------------w
w-------------w
w-------------w
d-------------d
w-------------w
w------1------w
w-------------w
wwwwwwwwwwwwwww
