wwwww-wwwww
w---------w
w---------w
w---------w
w---------w
-----------
w---------w
w---------w
wr-------rw
wrrr-r-rrrw
wwwwwwwwwww