wwwwwwwdwwwwwww
w-------------w
w-------------w
w-------------w
d-------------d
w-------------w
w-------------w
w-1----2----1-w
wwwwwwwwwwwwwww
