wwwwwdwwwww
w---------w
w-rr----r-w
w-r--r----w
w---rrr---w
w--rr-r---d
w---rrr---w
w-r--r----w
w-rr----r-w
w---------w
wwwwwdwwwww
