wwwwwwwdwwwwwww
w-------------w
w--3------rrr-w
w-----------r-w
w-------------d
w-----------r-w
w--3------rrr-w
w-------------w
wwwwwwwdwwwwwww
